1111111111
1001C00001
1000010111
1P0011E001
1111111111